b 0x400526
b 0x400527
b 0x40052a
b 0x40052f
b 0x400534
c
c
c
c
c
c
